
GRTE_SELF_SERVICE___SEQUOIA_BVT_10_BUILD_NUMBER	16472
GRTE_SELF_SERVICE___SEQUOIA_BVT_10_BUILD_RESULT	UNSTABLE
GRTE_SELF_SERVICE___SEQUOIA_BVT_11_BUILD_NUMBER	16482
GRTE_SELF_SERVICE___SEQUOIA_BVT_11_BUILD_RESULT	UNSTABLE
GRTE_SELF_SERVICE___SEQUOIA_BVT_12_BUILD_NUMBER	16466
GRTE_SELF_SERVICE___SEQUOIA_BVT_12_BUILD_RESULT	SUCCESS
GRTE_SELF_SERVICE___SEQUOIA_BVT_13_BUILD_NUMBER	16464
GRTE_SELF_SERVICE___SEQUOIA_BVT_13_BUILD_RESULT	UNSTABLE
GRTE_SELF_SERVICE___SEQUOIA_BVT_14_BUILD_NUMBER	16494
GRTE_SELF_SERVICE___SEQUOIA_BVT_14_BUILD_RESULT	SUCCESS
GRTE_SELF_SERVICE___SEQUOIA_BVT_15_BUILD_NUMBER	16502
GRTE_SELF_SERVICE___SEQUOIA_BVT_15_BUILD_RESULT	SUCCESS
GRTE_SELF_SERVICE___SEQUOIA_BVT_16_BUILD_NUMBER	16461
GRTE_SELF_SERVICE___SEQUOIA_BVT_16_BUILD_RESULT	SUCCESS
GRTE_SELF_SERVICE___SEQUOIA_BVT_17_BUILD_NUMBER	16481
GRTE_SELF_SERVICE___SEQUOIA_BVT_17_BUILD_RESULT	UNSTABLE
GRTE_SELF_SERVICE___SEQUOIA_BVT_18_BUILD_NUMBER	16462
GRTE_SELF_SERVICE___SEQUOIA_BVT_18_BUILD_RESULT	SUCCESS
GRTE_SELF_SERVICE___SEQUOIA_BVT_19_BUILD_NUMBER	16483
GRTE_SELF_SERVICE___SEQUOIA_BVT_19_BUILD_RESULT	UNSTABLE
GRTE_SELF_SERVICE___SEQUOIA_BVT_1_BUILD_NUMBER	16473
GRTE_SELF_SERVICE___SEQUOIA_BVT_1_BUILD_RESULT	SUCCESS
GRTE_SELF_SERVICE___SEQUOIA_BVT_20_BUILD_NUMBER	16479
GRTE_SELF_SERVICE___SEQUOIA_BVT_20_BUILD_RESULT	SUCCESS
GRTE_SELF_SERVICE___SEQUOIA_BVT_21_BUILD_NUMBER	16485
GRTE_SELF_SERVICE___SEQUOIA_BVT_21_BUILD_RESULT	UNSTABLE
GRTE_SELF_SERVICE___SEQUOIA_BVT_22_BUILD_NUMBER	16486
GRTE_SELF_SERVICE___SEQUOIA_BVT_22_BUILD_RESULT	UNSTABLE
GRTE_SELF_SERVICE___SEQUOIA_BVT_23_BUILD_NUMBER	16500
GRTE_SELF_SERVICE___SEQUOIA_BVT_23_BUILD_RESULT	SUCCESS
GRTE_SELF_SERVICE___SEQUOIA_BVT_24_BUILD_NUMBER	16495
GRTE_SELF_SERVICE___SEQUOIA_BVT_24_BUILD_RESULT	UNSTABLE
GRTE_SELF_SERVICE___SEQUOIA_BVT_25_BUILD_NUMBER	16487
GRTE_SELF_SERVICE___SEQUOIA_BVT_25_BUILD_RESULT	SUCCESS
GRTE_SELF_SERVICE___SEQUOIA_BVT_26_BUILD_NUMBER	16493
GRTE_SELF_SERVICE___SEQUOIA_BVT_26_BUILD_RESULT	UNSTABLE
GRTE_SELF_SERVICE___SEQUOIA_BVT_27_BUILD_NUMBER	16476
GRTE_SELF_SERVICE___SEQUOIA_BVT_27_BUILD_RESULT	SUCCESS
GRTE_SELF_SERVICE___SEQUOIA_BVT_28_BUILD_NUMBER	16470
GRTE_SELF_SERVICE___SEQUOIA_BVT_28_BUILD_RESULT	SUCCESS
GRTE_SELF_SERVICE___SEQUOIA_BVT_29_BUILD_NUMBER	16475
GRTE_SELF_SERVICE___SEQUOIA_BVT_29_BUILD_RESULT	UNSTABLE
GRTE_SELF_SERVICE___SEQUOIA_BVT_2_BUILD_NUMBER	16471
GRTE_SELF_SERVICE___SEQUOIA_BVT_2_BUILD_RESULT	SUCCESS
GRTE_SELF_SERVICE___SEQUOIA_BVT_30_BUILD_NUMBER	16484
GRTE_SELF_SERVICE___SEQUOIA_BVT_30_BUILD_RESULT	UNSTABLE
GRTE_SELF_SERVICE___SEQUOIA_BVT_31_BUILD_NUMBER	16478
GRTE_SELF_SERVICE___SEQUOIA_BVT_31_BUILD_RESULT	SUCCESS
GRTE_SELF_SERVICE___SEQUOIA_BVT_32_BUILD_NUMBER	16458
GRTE_SELF_SERVICE___SEQUOIA_BVT_32_BUILD_RESULT	UNSTABLE
GRTE_SELF_SERVICE___SEQUOIA_BVT_33_BUILD_NUMBER	16501
GRTE_SELF_SERVICE___SEQUOIA_BVT_33_BUILD_RESULT	SUCCESS
GRTE_SELF_SERVICE___SEQUOIA_BVT_34_BUILD_NUMBER	16463
GRTE_SELF_SERVICE___SEQUOIA_BVT_34_BUILD_RESULT	SUCCESS
GRTE_SELF_SERVICE___SEQUOIA_BVT_35_BUILD_NUMBER	16488
GRTE_SELF_SERVICE___SEQUOIA_BVT_35_BUILD_RESULT	UNSTABLE
GRTE_SELF_SERVICE___SEQUOIA_BVT_36_BUILD_NUMBER	16490
GRTE_SELF_SERVICE___SEQUOIA_BVT_36_BUILD_RESULT	SUCCESS
GRTE_SELF_SERVICE___SEQUOIA_BVT_37_BUILD_NUMBER	16492
GRTE_SELF_SERVICE___SEQUOIA_BVT_37_BUILD_RESULT	SUCCESS
GRTE_SELF_SERVICE___SEQUOIA_BVT_38_BUILD_NUMBER	16469
GRTE_SELF_SERVICE___SEQUOIA_BVT_38_BUILD_RESULT	SUCCESS
GRTE_SELF_SERVICE___SEQUOIA_BVT_39_BUILD_NUMBER	16499
GRTE_SELF_SERVICE___SEQUOIA_BVT_39_BUILD_RESULT	UNSTABLE
GRTE_SELF_SERVICE___SEQUOIA_BVT_3_BUILD_NUMBER	16459
GRTE_SELF_SERVICE___SEQUOIA_BVT_3_BUILD_RESULT	SUCCESS
GRTE_SELF_SERVICE___SEQUOIA_BVT_40_BUILD_NUMBER	16489
GRTE_SELF_SERVICE___SEQUOIA_BVT_40_BUILD_RESULT	SUCCESS
GRTE_SELF_SERVICE___SEQUOIA_BVT_41_BUILD_NUMBER	16477
GRTE_SELF_SERVICE___SEQUOIA_BVT_41_BUILD_RESULT	UNSTABLE
GRTE_SELF_SERVICE___SEQUOIA_BVT_42_BUILD_NUMBER	16491
GRTE_SELF_SERVICE___SEQUOIA_BVT_42_BUILD_RESULT	UNSTABLE
GRTE_SELF_SERVICE___SEQUOIA_BVT_43_BUILD_NUMBER	16468
GRTE_SELF_SERVICE___SEQUOIA_BVT_43_BUILD_RESULT	SUCCESS
GRTE_SELF_SERVICE___SEQUOIA_BVT_44_BUILD_NUMBER	16496
GRTE_SELF_SERVICE___SEQUOIA_BVT_44_BUILD_RESULT	UNSTABLE
GRTE_SELF_SERVICE___SEQUOIA_BVT_4_BUILD_NUMBER	16474
GRTE_SELF_SERVICE___SEQUOIA_BVT_4_BUILD_RESULT	SUCCESS
GRTE_SELF_SERVICE___SEQUOIA_BVT_5_BUILD_NUMBER	16467
GRTE_SELF_SERVICE___SEQUOIA_BVT_5_BUILD_RESULT	SUCCESS
GRTE_SELF_SERVICE___SEQUOIA_BVT_6_BUILD_NUMBER	16460
GRTE_SELF_SERVICE___SEQUOIA_BVT_6_BUILD_RESULT	SUCCESS
GRTE_SELF_SERVICE___SEQUOIA_BVT_7_BUILD_NUMBER	16497
GRTE_SELF_SERVICE___SEQUOIA_BVT_7_BUILD_RESULT	SUCCESS
GRTE_SELF_SERVICE___SEQUOIA_BVT_8_BUILD_NUMBER	16465
GRTE_SELF_SERVICE___SEQUOIA_BVT_8_BUILD_RESULT	SUCCESS
GRTE_SELF_SERVICE___SEQUOIA_BVT_9_BUILD_NUMBER	16498
GRTE_SELF_SERVICE___SEQUOIA_BVT_9_BUILD_RESULT	SUCCESS
GRTE_SELF_SERVICE___SEQUOIA_BVT_BUILD_NAME	SEQ-LLND2-REG-MailA-1.tests
GRTE_SELF_SERVICE___SEQUOIA_BVT_BUILD_NUMBER	16496
GRTE_SELF_SERVICE___SEQUOIA_BVT_BUILD_RESULT	UNSTABLE
LAST_TRIGGERED_JOB_NAME	GRTE Self Service - Sequoia BVT
MULTIJOB_ABORTED	0
MULTIJOB_FAILED	0
MULTIJOB_SKIPPED	0
MULTIJOB_STABLE	28
MULTIJOB_SUCCESSFUL	45
MULTIJOB_UNSTABLE	17
PHASE_ABORTED	0
PHASE_FAILED	0
PHASE_RESULT	UNSTABLE
PHASE_SKIPPED	0
PHASE_STABLE	28
PHASE_SUCCESSFUL	45
PHASE_UNSTABLE	17
SELF_SERVICE_ACCEPTANCE_ABORTED	0
SELF_SERVICE_ACCEPTANCE_FAILED	0
SELF_SERVICE_ACCEPTANCE_RESULT	UNSTABLE
SELF_SERVICE_ACCEPTANCE_SKIPPED	0
SELF_SERVICE_ACCEPTANCE_STABLE	28
SELF_SERVICE_ACCEPTANCE_SUCCESSFUL	45
SELF_SERVICE_ACCEPTANCE_UNSTABLE	17
TRIGGERED_BUILD_RUN_COUNT_GRTE_SELF_SERVICE___SEQUOIA_BVT	44
TRIGGERED_JOB_NAMES	GRTE Self Service - Sequoia BVT,GRTE Self Service - Sequoia BVT,GRTE Self Service - Sequoia BVT,GRTE Self Service - Sequoia BVT,GRTE Self Service - Sequoia BVT,GRTE Self Service - Sequoia BVT,GRTE Self Service - Sequoia BVT,GRTE Self Service - Sequoia BVT,GRTE Self Service - Sequoia BVT,GRTE Self Service - Sequoia BVT,GRTE Self Service - Sequoia BVT,GRTE Self Service - Sequoia BVT,GRTE Self Service - Sequoia BVT,GRTE Self Service - Sequoia BVT,GRTE Self Service - Sequoia BVT,GRTE Self Service - Sequoia BVT,GRTE Self Service - Sequoia BVT,GRTE Self Service - Sequoia BVT,GRTE Self Service - Sequoia BVT,GRTE Self Service - Sequoia BVT,GRTE Self Service - Sequoia BVT,GRTE Self Service - Sequoia BVT,GRTE Self Service - Sequoia BVT,GRTE Self Service - Sequoia BVT,GRTE Self Service - Sequoia BVT,GRTE Self Service - Sequoia BVT,GRTE Self Service - Sequoia BVT,GRTE Self Service - Sequoia BVT,GRTE Self Service - Sequoia BVT,GRTE Self Service - Sequoia BVT,GRTE Self Service - Sequoia BVT,GRTE Self Service - Sequoia BVT,GRTE Self Service - Sequoia BVT,GRTE Self Service - Sequoia BVT,GRTE Self Service - Sequoia BVT,GRTE Self Service - Sequoia BVT,GRTE Self Service - Sequoia BVT,GRTE Self Service - Sequoia BVT,GRTE Self Service - Sequoia BVT,GRTE Self Service - Sequoia BVT,GRTE Self Service - Sequoia BVT,GRTE Self Service - Sequoia BVT,GRTE Self Service - Sequoia BVT,GRTE Self Service - Sequoia BVT
